222222000000000000100000000000000000000
222222000000000000100000000000000000000
222222000000001100111100000000000011111
222220100000000000000100000000000010000
222000000011111100000100000000000010000
222000000011111100000111110000111110000
000000000011111100000000011111100000000
000000022211111100000000000000000000000
000011221211111100000000000000000110000
000000222201000000000010000000000110000
000000222201000000000000000000000000000
000000222200000000000000000000000000000
000000000000110010000002222202222200000
000000000000000000022222222202222222222
000000000000000000022222222202222222222
000000000000000000022222222202222222222
000100000222201100022222200000002112222
110100000222221100022222200111002222222
110000000222220000022222200101002222222
111100100022220000022220001000100022222
000100000222220000000220011000110022000
000100000222220000000000110000011000000