############
#          ###
#    P      ##   ######
#          ###   #    #
#######    #     #    #
#  O ##    #######    #
#    ##               #
#                 O   #
#      XX  ######     #
#       #  #    #     #
############    #######
